70
13
55
54
17
2
2
69
69
2
2
3
3
17
35
32
35
62
64
6
5
69
69
69
69
35
49
5
7
33
36
66
68
1111111111111111111111111111111111111111111111111111111111111111111111
1001111111111111111111111111111000011111111111111111111111111001111111
1001111111111111111111111111110000011111111111111111111111111000111111
1001111111111111111111111111111000011111111111111111111111111000111111
1001111111111111111111111111111000011111111111111111111111111000111111
1001111111111111111111111111111000011111111111111111111111111000011111
1000000000000000000000000000000000000000000000000000000000000000000111
1111100000000000000000000000000000000000000000000000000000000000000011
1111100000000000000000000000000000000000000000000000000000000000000011
1111100111111111111111111111111110011111111111111111111111111111110011
1111100111111111111111111111111110011111111111111111111111111111110011
1111100111111111111111111111111110011111111111111111111111111111110011
1111100111111111000000000000000000000000000000000000000111111111110011
1111100111111111111111111111111110011111111111111111111111111111110011
1111100111111111111111111111111110011111111111111111111111111111110011
1111100111111111111111111111111110011111111111111111111111111111110011
1111100000000000000000000000000000000000000000000000000000000000000011
1111100000000000000000000000000000000000000000000000000000000000000011
1111100111111111110111111111111111111110011111111111111001111000111111
1111100111111111110000011111111111111111011111111111111110111000111111
1111100111111111111100011111111111111111011111111111111111011000111111
1111100111111111111100011111111111111111011111111111111111101000111111
1111100111111111111100011111111111111111011111111111111110111000111111
1111100111111111111110011111111111111111111111111111111101111000111111
1111100111111111111111011111111111111111011111111111111011111000111111
1111100111111111111111001111111111111111111111111111110111111000111111
1111100111111111111111011111111111111111011111111111101111111000111111
1111100111111111111111011111111111111111101111111111011111111000111111
1111100111111111111110011111111111111111110111111110111111111000111111
1111100111111111111110011111111111111111111011111101111111111000111111
1111100111111111111110011111111111111111111101111011111111111000111111
1111100111111111111110011111111111111111111110111111111111111000111111
1111100111111111111110011111111111111111111111011111111111111000111111
1000100111111111111110011111111111111111111111100111111111111000110001
1400000000000000000000000000000000010000000000000000000000000000000031
1000111111111011111110111111011111011111110111110111111110001111110001
1111111111110001111100011110001110001111100011100011111100000111111111
1111111111100000111000001100000100000111000001000001111101111111111111
1111111111110001111100011110001110001111000111100011111110001111111111
1111111111111000111110111111011111011111110111110111111110000011111111
1111111111100011111000111110001100011111100011000011111111100011111111
1111111111111011111000001100000110000011000001000001111111111011111111
1111111111110001111100011110001111000111100011100011111111100011111111
1111111111100000111110111111011110000011110111110111111110000011111111
1111111111110001111100011110001111000111100011000001111111100011111111
1111111111111011111000001100000111011111000001100011111111110111111111
1111111111110001111100011110001100011111100011110111111111100011111111
1111111111100000011110111111011110000011110111100001111111000001111111
1111100000000000000000000000000000000000000000000000000000000000000011
1111100000000000000000000000000000000000000000000000000000000000000011
1111100111111111111111111111111110011111111111111111111111111111110011
1111100111111111111111111111111110011111111111111111111111111111110011
1111100111111111111111111111111110011111111111111111111111111111110011
1111100111111111000000000000000000000000000000000000000111111111110011
1111100111111111111111111111111110011111111111111111111111111111110011
1111100111111111111111111111111110011111111111111111111111111111110011
1111100111111111111111111111111110011111111111111111111111111111110011
1111100000000000000000000000000000000000000000000000000000000000000011
1111100000000000000000000000000000000000000000000000000000000000000011
1111110111111111111111111111111110001111111111111111111111111111111011
1111100011111110000000000011111100000111100000000000000000001111110001
1111000001111111110000001111111110001111111111111000011111111111111011
1111100011110000000000000000011111011111100000000000000000001111110001
1111110111111111111111111111111110001111111111111111111111111111110001
1111100011111111111111111111111100000111111111111111111111111111111011
1111000000000000000000000000000000000000000000000000000000000000000001
1111000111111111111111111111111100001111111111111111111111111111110001
1111000111111111111111111111111100001111111111111111111111111111110001
1111000111111111111111111111111100001111111111111111111111111111110001
1111111111111111111111111111111111111111111111111111111111111111111111