70
11
61
40
61
2
2
69
69
16
24
29
41
45
48
2
2
2
2
2
2
18
23
29
41
46
51
69
69
69
69
69
69
1111111111111111111111111111111111111111111111111111111111111111111111
1000000000000000101001001000000011000000000001000000000000001000000101
1000000000010000101001001000000000000000000001001111111111001001000101
1011111111010000101001001111111011111111110001000000000001001000110101
1000000001010000101001000000100001000010000001000000000001001000000101
1000000001010000110001000000100001000010001001111111111111001001000101
1111111111011111100001000000100100010000101000000000000000001001000001
1000000000000000100001000000100100010000101000000000000000001000000101
1000111111111111110001000000111111111111111000000000000000001111111001
1000000000000000000010011111111111111111111111111111111111111111000101
1111111111111110000010011000000000000000000000000000000000000110000101
1000000000000000000010011000111111111111111111111111111111111110000001
1111000011111111110010011000000000001100000000001100000000000110000001
1000000000000000000010011000000000001100000000001100000000000110000101
1111111100000001111110011000000001111100000011111100000000000110000001
1000000000000001000000011000000000001100000000001100000000000110000011
1001111111111001000000011000000000001100000000001100000000000110000101
1000000110000001000000011000000000001100000000001100000000000110000001
1000000110000001000000011000000000001100000000001100000000000110000101
1000011111110001000000011000011111111100011111111100000000000110000001
1000000110000001000000011000000000000000000000000000000000000010000101
1000000110000001000000011111111111111111111111111111111111111110000001
1001111111111101000000000000000000000000100000000000000000000000000001
1000000000000001111111111100000111111111100000000011111111111111100101
1000001110000000000000000100100000000000000000000000011110000011100001
1000000010000000000000000101000000000000001110000000000001110001100101
1000000011111111111110000100100000000000001101000000000000000101100101
1000000010001000000110000101001000000000010000100000011001110001100001
1000000010000000000110000100101000000000001100010000011000000001100001
1100000010000100000110000101001000111110000011001000111111111110000011
1110000000000010000110000100101000001100000001100100000000000000000111
1001000011000001000110000000001000001100000000000000000000000000001001
1000100001100000100000011111111000011110000000000011000000000000010001
1000110000110000010000000000000000001100011111111000110000000000110001
1400000000000000001000000000000000001100000011000000011100000000000031
1000110001111111000100000000000001111111000011000000000011111111110001
1000100000001000000010000000011000000110000111100000000000100001110001
1001000000001000000001000000011000000110000011000000000000000000001001
1110000001111111000000100011011001100110000011000000000111111110000111
1100000000001000000000000011000001100000011111111000000000000000000011
1000000000111110000000000011000001100000000000000000000001100000000001
1000000000000000000000000111111111111111110000110000000000000000000001
1000100101000000111111111110000000000000110000100100111111111111000001
1001000000100000000000000001001100110000110000000000111111111111000001
1010001100010011111111000001001100110000111111100000000001100000000001
1100001100001000000000000001001100110000111111100001110001100000000001
1000001100000100000111111001001100011000110000000000000001100001111111
1000001100000010000000000001001100011000111111100011111001100001111111
1000011110000001000000000001000000000000000000110000100001100000000001
1000110011000000100000011111111111111111100000110000100000000000000001
1001100001100000010000000000000000000000010000010011111001111111111111
1011000000110000001001111111111111101111110000110000000000000000000001
1110000000011000001000000000000000000000000000110011000111111110110011
1000000000000000001001000000000000001111001000111000000000000000110001
1000000000000000000001000000001100001111001000000000000000000000111001
1111111111111111111001010101000010001111001000011111111111111110110001
1000000000000000011001010101000010000000000000000000000000000000110011
1000000100000000010000011111100000001111111111100000000000000011000111
1000001100000001111100000000010000000000000000001111111111111100001001
1100001001111010000000000011111111111111100000001000000000000000001001
1000001100001010011111001000000000000000101000001000011111111111111111
1100001000111010000000001000001000000000101000001111110000000000000001
1000011111100010001100001000000000000000001000000000010000000000000001
1111111100000001111111100000001000000000101000000111110000000000000001
1000000100100100000000000000000000000100101000000000000000000000000001
1000000100100100000000001111111111111111101111001111110000000000000001
1111110100100100000000000000000000000000000000000000010000000000000001
1000000100000100000000000000011111111111100011111111110000000000000001
1001011010101111101010101010010000000000000000000000010000000000000001
1111111111111111111111111111111111111111111111111111111111111111111111