100
19
25
78
75
2
2
99
97
2
2
2
2
2
2
12
23
33
43
53
63
99
99
99
99
99
99
83
84
85
86
87
88
1111111111111111111111111111111111111111111111111111111111111111111111111111111111111111111111111111
1000001111100000011111000001111100000111110000011111000001111100000111110000011111000001111100000111
1100011111110001111111110001111110001111111000111111100011111110001111111000111111100011111110001111
1000001111100000011111000001111100000111110000011111000001111100000111110000011111000001111100000111
1100011111110001111111110001111110001111111000111111100011111110001111111000111111100011111110001111
1000001111100000011111000001111100000111110000011111000001111100000111110000011111000001111100000111
1100011111110001111111110001111110001111111000111111100011111110001111111000111111100011111110001111
1000000000000000000000000000000010000000000000000000000000000000000000000000000000000000000000000111
1000001111100000011111000001111100000111110000011111000001111100000111110000011111000001111100000111
1100011111110001111111110001111110001111111000111111100011111110001111111000111111100011111110001111
1000001111100000011111000001111100000111110000011111000001111100000111110000011111000001111100000111
1100011111110001111111110001111110001111111000111111100011111110001111111000111111100011111110001111
1000001111100000011111000001111100000111110000011111000001111100000111110000011111000001111100000111
1100011111110001111111110001111110001111111000111111100011111110001111111000111111100011111110001111
1000000000000000000000000000000000000000000000000000000000010000000000000000000000000000000000000111
1000001111100000011111000001111100000111110000011111000001111100000111110000011111000001111100000111
1100011111110001111111110001111110001111111000111111100011111110001111111000111111100011111110001111
1000001111100000011111000001111100000111110000011111000001111100000111110000011111000001111100000111
1100011111110001111111110001111110001111111000111111100011111110001111111000111111100011111110001111
1000001111100000011111000001111100000111110000011111000001111100000111110000011111000001111100000111
1100011111110001111111110001111110001111111000111111100011111110001111111000111111100011111110001111
1000000000000000000000000000001000000000000000000000000000000000000000000000000000000000000000000111
1000001111100000011111000001111100000111110000011111000001111100000111110000011111000001111100000111
1100011111110001111111110001111110001111111000111111100011111110001111111000111111100011111110001111
1000001111100000011111000001111100000111110000011111000001111100000111110000011111000001111100000111
1100011111110001111111110001111110001111111000111111100011111110001111111000111111100011111110001111
1000001111100000011111000001111100000111110000011111000001111100000111110000011111000001111100000111
1100011111110001111111110001111110001111111000111111100011111110001111111000111111100011111110001111
1000000000000000000000000000000000000000000000000000000000000000000100000000000000000000000000000111
1000001111100000011111000001111100000111110000011111000001111100000111110000011111000001111100000111
1100011111110001111111110001111110001111111000111111100011111110001111111000111111100011111110001111
1000001111100000011111000001111100000111110000011111000001111100000111110000011111000001111100000111
1100011111110001111111110001111110001111111000111111100011111110001111111000111111100011111110001111
1000001111100000011111000001111100000111110000011111000001111100000111110000011111000001111100000111
1100011111110001111111110001111110001111111000111111100011111110001111111000111111100011111110001111
1000000000000000000000000000000000000000000000000000000000000000000000000000000000100000000000000111
1000001111100000011111000001111100000111110000011111000001111100000111110000011111000001111100000111
1100011111110001111111110001111110001111111000111111100011111110001111111000111111100011111110001111
1000001111100000011111000001111100000111110000011111000001111100000111110000011111000001111100000111
1100011111110001111111110001111110001111111000111111100011111110001111111000111111100011111110001111
1000001111100000011111000001111100000111110000011111000001111100000111110000011111000001111100000111
1100011111110001111111110001111110001111111000111111100011111110001111111000111111100011111110001111
1000000000000000000000000000010000000000000000000000000000000000000000000000000000000000000000000111
1000001111100000011111000001111100000111110000011111000001111100000111110000011111000001111100000111
1100011111110001111111110001111110001111111000111111100011111110001111111000111111100011111110001111
1000001111100000011111000001111100000111110000011111000001111100000111110000011111000001111100000111
1100011111110001111111110001111110001111111000111111100011111110001111111000111111100011111110001111
1000001111100000011111000001111100000111110000011111000001111100000111110000011111000001111100000111
1100011111110001111111110001111110001111111000111111100011111110001111111000111111100011111110001111
1400000111000000000110000000111000000111000000011100000001110000000011100000000111000000111000003111
1000001111100000011111000001111100000111110000011111000001111100000111110000011111000001111100000111
1100011111110001111111110001111110001111111000111111100011111110001111111000111111100011111110001111
1000001111100000011111000001111100000111110000011111000001111100000111110000011111000001111100000111
1100011111110001111111110001111110001111111000111111100011111110001111111000111111100011111110001111
1000001111100000011111000001111100000111110000011111000001111100000111110000011111000001111100000111
1100011111110001111111110001111110001111111000111111100011111110001111111000111111100011111110001111
1000000000000000000100000000000000000000000000000000000000000000000001000000000000000000000000000111
1000001111100000011111000001111100000111110000011111000001111100000111110000011111000001111100000111
1100011111110001111111110001111110001111111000111111100011111110001111111000111111100011111110001111
1000001111100000011111000001111100000111110000011111000001111100000111110000011111000001111100000111
1100011111110001111111110001111110001111111000111111100011111110001111111000111111100011111110001111
1000001111100000011111000001111100000111110000011111000001111100000111110000011111000001111100000111
1100011111110001111111110001111110001111111000111111100011111110001111111000111111100011111110001111
1000000000000000000000000000000000000000000000000000000000000000000000000000000000000000000000000111
1000001111100000011111000001111100000111110000011111000001111100000111110000011111000001111100000111
1100011111110001111111110001111110001111111000111111100011111110001111111000111111100011111110001111
1000001111100000011111000001111100000111110000011111000001111100000111110000011111000001111100000111
1100011111110001111111110001111110001111111000111111100011111110001111111000111111100011111110001111
1000001111100000011111000001111100000111110000011111000001111100000111110000011111000001111100000111
1100011111110001111111110001111110001111111000111111100011111110001111111000111111100011111110001111
1000000000000000000001000000000000000000000000000000000000000000000000000000000000000000000000000111
1000001111100000011111000001111100000111110000011111000001111100000111110000011111000001111100000111
1100011111110001111111110001111110001111111000111111100011111110001111111000111111100011111110001111
1000001111100000011111000001111100000111110000011111000001111100000111110000011111000001111100000111
1100011111110001111111110001111110001111111000111111100011111110001111111000111111100011111110001111
1000001111100000011111000001111100000111110000011111000001111100000111110000011111000001111100000111
1100011111110001111111110001111110001111111000111111100011111110001111111000111111100011111110001111
1000000000000000000000000000000000000000000000000000000000000000000000000000000000000000000000000111
1000001111100000011111000001111100000111110000011111000001111100000111110000011111000001111100000111
1100011111110001111111110001111110001111111000111111100011111110001111111000111111100011111110001111
1000001111100000011111000001111100000111110000011111000001111100000111110000011111000001111100000111
1100011111110001111111110001111110001111111000111111100011111110001111111000111111100011111110001111
1000001111100000011111000001111100000111110000011111000001111100000111110000011111000001111100000111
1100011111110001111111110001111110001111111000111111100011111110001111111000111111100011111110001111
1000000000000000000000000000000000000000000000000100000000000000000000000000000000000000000000000111
1000001111100000011111000001111100000111110000011111000001111100000111110000011111000001111100000111
1100011111110001111111110001111110001111111000111111100011111110001111111000111111100011111110001111
1000001111100000011111000001111100000111110000011111000001111100000111110000011111000001111100000111
1100011111110001111111110001111110001111111000111111100011111110001111111000111111100011111110001111
1000001111100000011111000001111100000111110000011111000001111100000111110000011111000001111100000111
1100011111110001111111110001111110001111111000111111100011111110001111111000111111100011111110001111
1000000000000000000000000000000000000001000000000000000000000000000000000000000000000000000000000111
1000001111100000011111000001111100000111110000011111000001111100000111110000011111000001111100000111
1100011111110001111111110001111110001111111000111111100011111110001111111000111111100011111110001111
1000001111100000011111000001111100000111110000011111000001111100000111110000011111000001111100000111
1100011111110001111111110001111110001111111000111111100011111110001111111000111111100011111110001111
1000001111100000011111000001111100000111110000011111000001111100000111110000011111000001111100000111
1100011111110001111111110001111110001111111000111111100011111110001111111000111111100011111110001111
1000000000000000000000000000000000000000000000000010000000000000000000000000000000000000000000000111
1111111111111111111111111111111111111111111111111111111111111111111111111111111111111111111111111111