40
18
15
23
25
2
2
39
39
18
19
20
21
22
23
2
2
2
2
2
2
18
19
20
21
22
23
39
39
39
39
39
39
1111111111111111111111111111111111111111
1011111111111111111111111111111111111111
1011111111111111111111111111111111111111
1011111111111111111111111111111111111111
1011111111111111111111111111111111111111
1011111111111111111111111111111111111111
1011111111111111111111111111111111111111
1011111111111111111111111111111111111111
1011111111111111111111111111111111111111
1011111111111111111111111111111111111111
1011111111111111111111111111111111111111
1011111111111111111111111111111111111111
1011111111111111111111111111111111111111
1011111111111111111111111111111111111111
1011111111111111111111111111111111111111
1011111111111111111111111111111111111111
1011111111111111111111111111111111111111
1000000000000000000000000000000000000001
1000000000000000000000000000000000000001
1000000000000000000000000000000000000001
1400000000000000000000000000000000000031
1000000000000000000000000000000000000001
1000000000000000000000000000000000000001
1111111111111111111111111111111111111101
1111111111111111111111111111111111111101
1111111111111111111111111111111111111101
1111111111111111111111111111111111111101
1111111111111111111111111111111111111101
1111111111111111111111111111111111111101
1111111111111111111111111111111111111101
1111111111111111111111111111111111111101
1111111111111111111111111111111111111101
1111111111111111111111111111111111111101
1111111111111111111111111111111111111101
1111111111111111111111111111111111111101
1111111111111111111111111111111111111101
1111111111111111111111111111111111111101
1111111111111111111111111111111111111101
1111111111111111111111111111111111111101
1111111111111111111111111111111111111111