70
27
62
43
10
2
2
69
69
24
24
24
46
46
46
3
4
5
3
4
5
24
24
24
46
46
46
66
67
68
66
67
68
1111111111111111111111111111111111111111111111111111111111111111111111
1011111111111111111111111111111111111111111111111111111111111111111111
1001111111111111111111111111111111111111111111111111111111111111111111
1000111111111111111111111111111111111111111111111111111111111111111111
1000011111111111111111111111111111111111111111111111111111111111111111
1000001111111111111111111111111111111111111111111111111111111111111111
1000000111111111111111111111111111111111111111111111111111111111111111
1100000011111111111111111111111111111111111111111111111111111111111111
1111000000111111111111111111111111111111111111111111111111111111111111
1111100000011111111111111111111111111111111111111111111111111111111111
1111111000000111111111111111111111111111111111111111111111111111111111
1111111100000011111111111111111111111111111111111111111111111111111111
1111111110000001111111111111111111111111111111111111111111111111111111
1111111111100000011111111111111111111111111111111111111111111111111111
1111111111100000011111111111111111111111111111111111111111111111111111
1111111111110000001111111111111111111111111111111111111111111111111111
1111111111111000000111111111111111111111111111111111111111111111111111
1111111111111100000011111111111111111111111111111111111111111111111111
1111111111111110000000111111111111111111111111111111111111111111111111
1111111111111111000000111111111111111111111111111111111111111111111111
1111111111111111100000011111111111111111111111111111111111111111111111
1111111111111111110000001111111111111111111111111111111111111111111111
1111111111111111111000000111111111111111111111111111111111111111111111
1100000000000000000000000000000000000000000000000000000000000000000011
1100111111111111110000111111111111101111111111111111111111111111110011
1100111110000000000000000000011111101111111111111111111111111111110011
1100111110000000000000000000011111101111110000000000000000000011110011
1100111110000000000000000000011111101111110000000000000000000011110011
1100111111111111100000111111111111101111110000000000000000000011111011
1100111111111111100000111111111111101111111111000011111111111111110011
1100000000001111100000111111111111101111111111000011111111000000000011
1100111111001111100000111111111111101111111111000011111111001111110011
1100111111001111100000111111111111101111111111000011111111001111110011
1000111111001111100000111111111111101111111111000011111111001111110001
1400111111001111100000111111111111101111111111000011111111001111110031
1000111111001111100000111111111111101111111110000011111111001111110001
1100111111001111100000111111111111101111111111000011111111001111110011
1100111111001111100000111111111111101111111111000011111111001111110011
1100000000011111100000111111111111101111111111000011111111100000000011
1100111111111111100000111111111111101111111111000011111111111111110011
1100111110000000000000000000011111101111110000000000000000000011110011
1100111110000000000000000000011111101111110000000000000000000011110011
1100111110000000000000000000011111101111110000000000000000000011110011
1100111111111111111111111111111111101111110000000000000000000011110011
1100111111111111111111111111111111101111111111111110000111111111110011
1100000000000000000000000000000000000000000000000000000000000000000011
1111111111111111111111111111111111111111111111100000001111111111111111
1111111111111111111111111111111111111111111111110000000111111111111111
1111111111111111111111111111111111111111111111111000000001111111111111
1111111111111111111111111111111111111111111111111100000011111111111111
1111111111111111111111111111111111111111111111111110000000111111111111
1111111111111111111111111111111111111111111111111111000000011111111111
1111111111111111111111111111111111111111111111111111100000000111111111
1111111111111111111111111111111111111111111111111111110000000011111111
1111111111111111111111111111111111111111111111111111111100000011111111
1111111111111111111111111111111111111111111111111111111110000000111111
1111111111111111111111111111111111111111111111111111111111000000011111
1111111111111111111111111111111111111111111111111111111111100000001111
1111111111111111111111111111111111111111111111111111111111100000011111
1111111111111111111111111111111111111111111111111111111111110000001111
1111111111111111111111111111111111111111111111111111111111111000000011
1111111111111111111111111111111111111111111111111111111111111000000011
1111111111111111111111111111111111111111111111111111111111111100000001
1111111111111111111111111111111111111111111111111111111111111110000001
1111111111111111111111111111111111111111111111111111111111111111000001
1111111111111111111111111111111111111111111111111111111111111111100001
1111111111111111111111111111111111111111111111111111111111111111110001
1111111111111111111111111111111111111111111111111111111111111111111001
1111111111111111111111111111111111111111111111111111111111111111111101
1111111111111111111111111111111111111111111111111111111111111111111111