40
16
39
24
2
2
2
39
39
16
24
19
39
18
23
2
2
6
2
8
13
16
24
21
18
14
27
39
39
35
28
31
33
1111111111111111111111111111111111111111
1000110000000000001111000000001100000001
1000001100000110000011111000000110000001
1000011110001100000000000110000011100001
1000110000110000100000001111110001100001
1000011000001101001111000011000001110111
1000001100011000000000000000000001011001
1000000110011000110001100110011000001101
1011000011100000001011001000110000000111
1000110000001100001100011001101011001101
1000011000000011000110110000110000011001
1000000000000000000011000000011000110001
1001000011001000100000000000001101100001
1000110011011000000000000000000110000001
1000000000000000111110000111001000000001
1000000001100001000001000000000000000001
1111100001100010000000100111101000011111
1000111000000000000000000000010100010001
1000100100011000100000001000000010010001
1400000010011000010110000100010010000031
1000100001011000000000000010000001010001
1000100000101100000000000110000000110001
1111100000010011000000011000000000011111
1000000011001000110000110001000001000001
1000100100001000001111000000000000000001
1000000010000001000000000111100000001001
1000000011100000001000000110011100000001
1000000100001000000000001100000011000001
1001000100001000001000000000000000000001
1000001000000100000000110000100010001101
1000010011000010000000011000100001001101
1000100100100100001100001100010010001101
1000000000000000000000000110000010001101
1010000100010000001010000011000010001101
1001000010100001110000000000101000001101
1000100001000110001001000010000000011001
1000010000000011000001000100000000011001
1000001000000001100011000100000001110001
1000000000000000010110000011000110000001
1111111111111111111111111111111111111111