100
99
95
2
18
2
3
99
99
3
4
5
6
7
8
3
3
3
3
3
3
89
90
91
92
94
95
99
99
99
99
99
99
1111111111111111111111111111111111111111111111111111111111111111111111111111111111111111111111111111
1100000000000000000000000000000000000011111100000000000000000000000111111000000000000000000000000001
1100000000000011111100000000000000111100000000000000000000001111111110000000000000000000110000000001
1100000000000000000000000000000000000000011111111111000000000000000000000000001000000000000000000001
1100000000000000000000000000000000000000000000000000000000000000000000000000000100000000000000000001
1100000111111111111111111111111111111111111111111100000000000000000000000000000010100000000000000001
1100000000000000000000000000000000000000000000000000000000000000000000000000000000110100000111100001
1100000000000000000000000000000000000000000000000000000000000000000000000000000000000100000011000001
1100000000000000001111111111111111111111111111111111111111111111111111111000000000000010000000000001
1100000000000000000000000000000000000000000000000000000000000000000000000000000000000001000110000001
1100000111111111111111111111111111111111111111111111000000000000000000000000000000000001000000000001
1100000000000000000000000000000000000000000000000000000000000000000000000000000000000000100000000001
1100000000000000000000000000000000000000000000000000000000000000000000000000000000000000010000000001
1100000111111110000001111111111111111111111111111111111111111111111111111110000000000000010000000001
1100000000000000000000000000000000000000000000000000000000000000000000000000000000000000001100000001
1100001111111110000000000000000001111111111111111111111111111111111110000000000000000000000010000001
1100000000000000000001111100000000000000000000000000000000000000000000000000000000000000000001000001
1100000000000000000000000000000000000000000000000000000000000000000000000000111111100000000000100001
1100000000000001111111111111110000000000000000000000001111111100000000000000000000000000000000010001
1100000000000000000000000000000000000000000000000000000000000001111111111110000000001111111000001001
1100000000000000000000000000000000001111110000000000000000000000000000000000000000000111111111110111
1100000111111111000100000000000000000000000000000000000000000000011111000000000000000000000000000001
1100000000000000000010000000000000000000000000000000000000011111000011111100000111111100000000000001
1100000000000000000001000000000000000000000000000000000000000000000000000000000000000000000000000001
1100000000000000000000010000000000000000000000000000000000000000000000000000000000000000000000000001
1100000000000000000000000100000000000000001110111111111111111111111111111100000000000000000000000001
1100000000111111100000000001000000011110000000000000000000000000000000000000000000000000000000000001
1100000000000000000000000000000000000000000000000000000000000000000000000000001111111111100000000001
1100000000000000000000000000000100000000000000000000000000000000000000000000000000000000000000000001
1100000000000000000000000000000001000000000001111111111111111111111111111111000000000000000000000001
1100001111111111100000000000000000010000000000000000000000000000000000000000000000000000000000000001
1100000000000000000000000000000000000100011111100000000000000000000111111111111000000000000000000001
1100000000000000000000000000000000000001000000000000000000000000000000000000000000000000000000000001
1100000000111111000000000000000000000000010000000001111111100000000000000000111111111111110000000001
1100000000000000000000000000000000000000000100000000000011111100011111000000000000000000000000000001
1100000001110000001111111000000000000000000001000000000000000000000000000000000000000000000000000001
1100000000000000000000000000000000000000000000010000000000000000000000000000000000000000000000000001
1100000000000000000000000000000010110110110110101110111101110111111110111000000000000000000000000001
1100000000000000000000000111111100000000000000000001000000000000000001111100000000000000000000000001
1100000011111111000000001100000000000000000010000000010000000000000000011110000001111000000000000001
1100000000000000000001111000000000000000000111111111111111000000000000000011100000000000000011111001
1100000000000000000011000000000000111111111000000000000001100000000000000011100000000000000000000001
1100000001111000000110000001111111000000000000000000000000011100000000000011100000000000000000000001
1100000000000000000000000000000000011111111111111111111110000111000000000001100000000000000000000001
1100000000000000011000000010011111100000000000000000000011000001110000000000110000001111110000000001
1100001111111111010000000100100000001111111111111111100001100000011000000000110000000000000000000001
1111111000000000010000000100100000001000000000000000110000110000001110000000011000000000000000111111
1100010000000000010000001100100001100000000000000000001100011000100011100000001100000000000000010001
1100010000000000010000011000100011000000011111111111000110001100110000110000000110000001111110010001
1100010000000000010000011000100011100001110000000011100011000110000001110100000011000000000000010001
1140000000000000010000010000100011000000000000000001110001100011000000110001000011000111111000000031
1100010000000000010000010000100010000111000110011000111100110001100000001000010001100000000000010001
1100010000000000010000010000100010000110001000001100011100011000110000001100000111100000000000010001
1100010000000000110000010000100011000110001000000110001100001100110000001100000011000000011100010001
1111111000000000110000010000100011000111000100000110000100000110011000001100000110000000000000111111
1100000000000000111000010000100011100011100000000110000010001100001100111100000110010000000000110001
1100000000000000011000010000100011100001110000001100000110001100011000011000000110000001111000000001
1100000000000000001000011000110011100000011100011000001110001100110000001100001100000000000000000001
1100000000000000001100011100011000111000001101110000011100011000110000001100001100000000000000000001
1100000000000000000110001100011100001110000111000000111000011000110010011000000110000000000000000001
1100000000000000000011000110000011100011100000000001110000110000110100111000000110000000000000000001
1100000000000000000001000011110000110000111111100111000000110001100000110000000110000000000000000001
1100010000000000000001100000011100011110000001111100000001100001100100110000000011000000000001100001
1100000000000000000001110000000011000001110000000000000011100011010001100000000010000000001000000001
1100000000000000000000011110000010011000011111111111111110000011001001100000000010000000000000000001
1100000000000000000000001111000001111100000000000000000000000011001001100000000110000000000000000001
1100000000000000000000000111000000001111111111111111111111111110000011100000000110000000000000000001
1100000000000000100000000011100000000000000000000001100000110000000011000000000011000000010000000001
1100000001000000000000000001110000000000000000000000000000000011100011000000000111100000000000000001
1100000000000000000100000000111100000000000000100000000011000000000110000000001110110000000011000001
1100000000000000000000000000011111000000000011111111111111111111111100000000011000000000000000000001
1100000000000100000000000000000001111100001111111111100000000000000000000000011000000000000000000001
1100000000000000000000000000000000001111111100000000000000000000000000000000110000000100011000000001
1100000001000010000000000000000000000000000000000000000000000000000000001111110000000000000000000001
1100000000000000000000000000000000000000000000000000000000000000000111111000000000010000000010000001
1100000000000000000000010000000111111000000000000000000000000000111110000000000000000000000000000001
1100000000000000000000000000000000000111111111111111111111111111000000000000000000000000000000000001
1100111111111111111100000000000000000000000000000000000000000000100000000000000000000000000000000001
1100000000000000000100000000000000000000000000000000000000000000000000000000000000000100000000000001
1100000000000000000100000000000000000000000000000000000000000000000000000000000000010011000000000001
1100000000000000000100000000000000000000000101001010000000000000000000000000000011010000010100000001
1100001100000000000110000000000000000000101000110001000000000000000000000000000110000000000100000001
1100000010000000000110000000000000000001000000000000010000000000000000000000001000000000000010000001
1100000001000000000010000000000000001010000000000000001100000000000000000000010000000000000001000001
1100000001000000000001000000000000010000000000000000000011000000000000000000100000000000000000100001
1100000000110000000000100000000010100000000000000000000000110000000000000001000000000000000000010101
1100000000001000000000110000000010000000000000000000000000001100000000000110000000000000000000000011
1100000000001000000000010000110100000000000000000000000000000011000000101000000000000000000000000011
1100000000000010101000010110010000000000000000000000000000000000100010000000000000000000000000000001
1100000000000010000110000000000000000000001000000000010000000000010100000000000001000000000000000001
1100000000000000000010000000000000000000000000000000000000000000000000000000000001010000000000000001
1100000000000000000001000000010000000000000000000000010000000000000000000000001100000100000000000001
1100011100000000000000100000000000000000000000000101100000000000000010000011100001001100000000000011
1100000010000000000000001010000000000000000000010000001000000000000000011010000000000010000000000001
1100000010000000000000100001010000010000000001000000001101000000000000110000000000000001000000000001
1100000001000000000001000000010100000000000010000000000001000100001001000000000000000001010000000011
1100000001010000010100100000000110000000001000000000010000100000000100000000000000000000011000000101
1100000000010000010000000000000000100010100000000000000000011010010000000000000000000000000010010001
1100000000000110100000000000000000001000000000000000000000000001000000000000000000000000000001000001
1111111111111111111111111111111111111111111111111111111111111111111111111111111111111111111111111111