40
4
34
20
13
2
2
39
39
18
18
18
22
22
22
2
3
4
2
3
4
18
18
18
22
22
22
37
38
39
37
38
39
1111111111111111111111111111111111111111
1000000000000000000000000000000000000011
1101111111010101111111111111111111110011
1101100000010101000000000000000000110011
1101101110010101011111111111111111110011
1101101100010001011111111011111111010011
1101101100011011000111111000000000010011
1101101110011000100001111011111011010011
1101101110010010011000011011001001110011
1101101110001101111111000011001001111011
1101100000011000000000000001011011110011
1101111111011011111111111011011011110011
1101111111011011111111111011010011110011
1100000000011011111111111011011001010011
1110110110111011000000111011011000000011
1110110000111011011110111011011101110011
1111111110111011011110111011000111110111
1000011110111011000010000011110111000001
1000011110111011111110111011110111100001
1400000000110000000000000000000000000031
1000011110111111101100111011110111100001
1000011110111000001110111011110111100001
1111111110111000001100111011111111111111
1100001110111111101100111000000000000011
1101100110111000001100111011111111111011
1101100000110001101110111011000000011011
1101111111111101101100111011011111001011
1100000000000000101110111011011111011011
1101111111111100101110111011011011011011
1101111111111100101110111011011011011011
1100000000000000101100000000000000011011
1101111111111111101110111011011011011011
1100000000000000001110111011011011011011
1101111111101101111110111011011000011011
1101111110111101111111111011011111111011
1100000000000000000000000011000000000011
1101111111111111111110011011111111110011
1100000000000000000000111000000000000111
1111111111110000001111111111110000000001
1111111111111111111111111111111111111111