100
88
11
3
78
2
2
99
99
50
50
50
50
50
50
4
5
6
7
8
9
50
50
50
50
50
50
91
92
93
94
95
96
1111111111111111111111111111111111111111111111111111111111111111111111111111111111111111111111111111
1000011111000011111111111111111111111111111111111111111111111111111111111111111111111111111111111111
1100011111100011111111000001111110000011111000001111110000001111110000000000001111111111111111111111
1100011111100011111111001100111111000001110000011111100011000111110000111100000001111111111111111111
1100011111100011111110001100011111100000000001111111000111100011110000111111100000111111111111111111
1100000000000011111100000000001111111100000111111110001111110001110001111100000011111111111111111111
1100011111100011111000111111000111110000000000111111001111110011100000000000111111111111111111111111
1100011111100011110001111111000011100001110000011111100111110011100001111000001111111111111111111111
1100011111100011100001111111000011000001111000001111110011100111100011111100000011111111100111111111
1000001111000000000000111111100000000011111100000000000000000000000000001111000000000000000001111111
1111111111111111111111111111111111111111111111111111111111111111111111111111111111111111000011111111
1111111111111111111111111111111111111111111111111111111111111111111111111111111111111111000001111111
1111111111000001111111111111111111111111111111111111111111111111111111111111111111111111000001111111
1111111111100011111110000011111100000000000000011111110000000000001111111110001111111111000011111111
1111111111100001111110000011111111111111111100011111111111111110001111111110001111111111000001111111
1111111111100001111110000011111111111111111100011111111111111110001111110000000000000000000000111111
1111111111000011111110000011111111111110000000011111111111110000001111111110001111111111111111111111
1111100000000001111110000011111111111111111100011111111111111110001111111110001111111111111111111111
1111100011110000111111000011111111111111111100011111111111111110001111111110001111111111111111111111
1111100011110001111110000011111111111111111100011111111111111110001111111110001111111111111111111111
1111100000000000000000000000000000000000000000000000000000000000000000000000000000000000011111111111
1111111000001111111111111111111111111111111111111111111111111111111111111111111111111111111111111111
1111111100001111111111111111111111111111111111111111111111111111111111111111111111111111111111111111
1111111110111111111111111111111011110011111111111000000000000111111111111111111111111111111111111111
1111111000000011100011111111110001111001111111110011001111111110000000000001000000000000111000111111
1111111000001001000000011111100100111100111111100111000111111110001111110111000111111100110001111111
1111111000001100010000011111001110011110011111001111000111111110001111100011000111111100000011111111
1111111000001111110000011110011111001111001110011111000000111110001111100011000111111100001111111111
1111111000001111110000011100111111100111100100111111000111111110001111100011000111111100100111111111
1111111000001111110000000001111111110000000001111111000000000000011111100000000000000100110000111111
1111111111111111111111111111111111111111111111111111111111111111111111111111111111111111111001111111
1111111111111111111111111111111111111111111111111111111111111111111111111111111111111111110001111111
1111111111111111111111111111111111111111111111111111111111111111111111111111111111111111111000111111
1111111111111111111111111111111111111111111111111111111111111111111111111111111111111111110001111111
1111111100001111111111000011111111111111111111111111111111111110000011111111111111111111111100001111
1111111100001111111100001111111111111111111111111111111111111111100000111111111111111111111110001111
1111111100001111111000011111111111111111111111111111111111111111111000001111111111111111111100001111
1111111100001111000001111111111111111111111111111111111111111111111110000011111111111111111000001111
1111111100000000000001111111111111111111111111111111111111111111111111110000011111111111000001111111
1111111100001111110000001111111111111111111111111111111111111111111111111110000011111000000000011111
1111111100011111111110000011111111111111111111111111111111111111111111111111100000000001111000001111
1111111100011111111111100000011111111111111111111111111111111111111111111111111100001111111000011111
1111111100011111111111111100001111111111111111111111111111111111111111111111110000011111111000011111
1111111100011111111111111111000001111111111111111111111111111111111111111111110000111111111000011111
1111111000001111111111111111111000011111111111111111111111111111111111111111000001111111111000011111
1111111000011111111111111111111110000001111111111111111111111111111111111000000111111111111000011111
1111111100011111111111111111111111100000011111111111111111111111111111110000001111111111111000011111
1111111100011111111111111111111111111100000000000000000000000000000000000001111111111111111000011111
1111110111110111110111110111110111110111110111110101111110111111011111101111110111110111110111101111
1400000000000000000000000000000000000000000000000010000000000000000000000000000000000000000000000031
1111011110111110111101111011110111101111011110111101101110111011110111101111011110111011110111101111
1111111100001111111111110001111111111111111111111111111111111100000111111111111111111111111110000111
1111111100001111111111000011111111111111111111111111111111111110000011111111111111111111111100001111
1111111100001111111100001111111111111111111111111111111111111111100000111111111111111111111110001111
1111111100001111111000011111111111111111111111111111111111111111111000001111111111111111111100001111
1111111100001111000001111111111111111111111111111111111111111111111110000011111111111111111000001111
1111111100000000000001111111111111111111111111111111111111111111111111110000011111111111000001111111
1111111100001111110000001111111111111111111111111111111111111111111111111110000011111000000000011111
1111111100011111111110000011111111111111111111111111111111111111111111111111100000000001111000001111
1111111100011111111111100000011111111111111111111111111111111111111111111111111100001111111000011111
1111111100011111111111111100001111111111111111111111111111111111111111111111110000011111111000011111
1111111100011111111111111111000001111111111111111111111111111111111111111111110000111111111000011111
1111111000001111111111111111111000011111111111111111111111111111111111111111000001111111111000011111
1111111000011111111111111111111110000001111111111111111111111111111111111000000111111111111000011111
1111111100011111111111111111111111100000011111111111111111111111111111110000001111111111111000011111
1111111100011111111111111111111111111100000000000000000000000000000000000001111111111111111000011111
1111111100011111111111111111111111111111111111111111111111111111111111111111111111111111111111111111
1111111100011111111111111111111111111111111111111111111111111111111111111111111111111111111111111111
1111111100001111111111111111111111111111111111111111111111111111111111111111111111111111111111111111
1111111110111111111111111111111011110011111111111000000000000111111111111111111111111111111111111111
1111111000000011100011111111110001111001111111110011001111111110000000000001000000000000111000111111
1111111000001001000000011111100100111100111111100111000111111110001111110111000111111100110001111111
1111111000001100010000011111001110011110011111001111000111111110001111100011000111111100000011111111
1111111000001111110000011110011111001111001110011111000000111110001111100011000111111100001111111111
1111111000001111110000011100111111100111100100111111000111111110001111100011000111111100100111111111
1111111000001111110000000001111111110000000001111111000000000000011111100000000000000100110000111111
1111111111000001111111111111111111111111111111111111111111111111111111111111111111111111000001111111
1111111111100011111110000011111100000000000000011111110000000000001111111110001111111111000011111111
1111111111100001111110000011111111111111111100011111111111111110001111111110001111111111000001111111
1111111111100001111110000011111111111111111100011111111111111110001111110000000000000000000000111111
1111111111000011111110000011111111111110000000011111111111110000001111111110001111111111111111111111
1111100000000001111110000011111111111111111100011111111111111110001111111110001111111111111111111111
1111100011110000111111000011111111111111111100011111111111111110001111111110001111111111111111111111
1111100011110001111110000011111111111111111100011111111111111110001111111110001111111111111111111111
1111100000000000000000000000000000000000000000000000000000000000000000000000000000000000011111111111
1100001111111111111111111111111111111111111111111111111111111111111111111111111111111111111111111111
1100011111111111111111111111111111111111111111111111111111111111111111111111111111111111111111111111
1000011111000011111111111111111111111111111111111111111111111111111111111111111111111111111111111111
1100011111100011111111000001111110000011111000001111110000001111110000000000001111111111111111111111
1100011111100011111111001100111111000001110000011111100011000111110000111100000001111111111111111111
1100011111100011111110001100011111100000000001111111000111100011110000111111100000111111111111111111
1100000000000011111100000000001111111100000111111110001111110001110001111100000011111111111111111111
1100011111100011111000111111000111110000000000111111001111110011100000000000111111111111111111111111
1100011111100011110001111111000011100001110000011111100111110011100001111000001111111111111111111111
1100011111100011100001111111000011000001111000001111110011100111100011111100000011111111100111111111
1000001111000000000000111111100000000011111100000000000000000000000000001111000000000000000001111111
1111111111111111111111111111111111111111111111111111111111111111111111111111111111111111000011111111
1111111111111111111111111111111111111111111111111111111111111111111111111111111111111111000001111111
1111111111111111111111111111111111111111111111111111111111111111111111111111111111111111000000000001
1111111111111111111111111111111111111111111111111111111111111111111111111111111111111111111111111111