40
13
2
20
38
2
2
39
39
2
4
4
4
9
13
39
16
20
22
29
2
39
37
37
37
27
28
2
24
20
18
10
39
1111111111111111111111111111111111111111
1000000000000000000040000000000000000001
1000000000000001111111111111110000000001
1000000000000000100010000000000000000001
1111111111000000100010000000001100000001
1000000000000000100000000000011111110001
1000000000111111100010000000110000000001
1000011111000000000010000001100000011111
1000000100000000100000000011000000000001
1111100110000000100000000111111111110001
1000000011000000100000001100000000000001
1000011111100000000000011000000000011101
1000000000110000000000110000000000000001
1111111000011000000001101111111100000001
1000000000001100000011000000000000000001
1000001111111110001110000000000000000001
1000000000000000000000000000000111111111
1000000000000000000000000000000000000001
1000000000000000000111111111111111100001
1000000000000000000000000000000000000001
1000000111111100000000001111111111111111
1000000000000000000000110000000000000001
1000000000000011100000011000000001111111
1111111000000110000000001100000000000001
1000000000001100000010000110000111111001
1000011111111000000010000011000000000001
1000000000110000000010001001111111100001
1000000001100000000010001000110000000001
1111100011000000000010001000011000001111
1000000110000000000010001000001100000001
1000001100000000000010000000000111111001
1000011000000001110010001000000011000001
1000000000000000000010001000000000000001
1000000000000000000010001000000000000001
1000111111111110000000001000000000000001
1000000000000000000010001000001111111101
1000000000000000000010001000000000000001
1000000000000011111111111111000000000001
1000000000000000000030000000000000000001
1111111111111111111111111111111111111111