40
10
20
31
21
2
2
39
39
3
34
7
15
26
38
6
2
2
2
2
6
3
34
7
15
26
38
35
39
39
39
39
35
1111111111111111111111111111111111111111
1000111000110000000000000000110001110001
1000101010011000000000000001100101010001
1000100001001100000000000011001000010001
1100000100100011111001111100010010000011
1111000010011000000000000001100100001111
1001110001001110000000000111001000111001
1000001100100010000000000100010011000001
1000000100011010000000000101100010000001
1000100100001011000000001101000010010001
1000100110001011111111111101000110010001
1000100011000010000000000100001100010001
1000010001110001100000000000111000100001
1000001000000000011100010000000001000001
1000001000001100000000010000000001000001
1111001111100011110000111100011111001111
1001000001100000001110000000011000001001
1001000000000011000001111000000000001001
1001000000000011000000001000000000001001
1400000001100000000110001111111000000001
1000000001111111000110000000011000000031
1001000000000001000000001100000000001001
1001000000000001111000001100000000001001
1001000001100000000111000000111000001001
1111001111100011110000111100011111001111
1000001000000000100000000011000001000001
1000001000000000100011100000000001000001
1000010001110000000000011000111000100001
1000100011000010000000000100001100010001
1000100110001011111111111101000110010001
1000100100001010000000000101000010010001
1000000100011010000000000101100010000001
1000001100100010000000000100010011000001
1001110001001110000000000111001000111001
1111000010011000000000000001100100001111
1100000100100011111001111100010010000011
1000100001001100000000000011001000010001
1000101010011000000000000001100101010001
1000111000110000000000000000110001110001
1111111111111111111111111111111111111111